5
20
20
xxxxxxxxxxxxxxxxxxxx
x..................x
x..................x
xxxxxxxxxxxxxxxxx..x
x..................x
x..xxxxxxxxxxxxxx.xx
x..x............x..x
x.xx.xxxxxxxxxx.x..x
x..x..x.......x.x.xx
xx.xx.x.xxxxx.x.x..x
x..x..x.x...x.x....x
x.xx.xx.x.x.xxxxxxxx
x..x......x........x
xx.xxxxxxxxxxxxxxx.x
x..................x
xxxxxx........xxxxxx
x..................x
x..................x
x..................x
xxxxxxxxxxxxxxxxxxxx